! Kilobolt Studios
! http://kilobolt.com
! Game Development Tutorial - Unit 3
! Q-Bot Level 1
! # = Tile Legend
! W = Wall
! D = Dirt
! G = Grass
WWWWWWWWWWWWWWWWWWWWWWWWWWWWWWWWWWWWWWWWWWWWWWWWWWWWW
WGGGGGGGGGGGGGGGGGGGGGGGGGGGGGGWDDDDDDDDDDDDDDDDDDDDW
WGGGGGGGGGGGGGGGGGGGGGGGGGGGGGGDDDDDDDDDDDDDDDDDDDDDW
WGGGGGGGGGGGGGGGGGGGGGGGGGGGGGGDDDDDDDDDDDDDDDDDDDDDW
WGGGGGGGGGGGGGGGGGGGGGGGGGGGGGGWDDDDDDDDDDDDDDDDDDDDW
WGGGGGGGGGGGGGGGGGGGGGGGGGGGGGGWWWWWWWWWWWWWWWWWWWDDW
WGGGGGGGGGGGGGGGGGGGGGGGGGGGGGGW                 WDDW
WGGGGGGGGGGGGGGGGGGGGGGGGGGGGGGW                 WDDW
WGGGGGGGGGGGGGGGGGGGGGGGGGGGGGGW   WWWWWWWWWWWWWWWDDW
WGGGGGGGGGGGGGGGGGGGGGGGGGGGGGGW   WWWWWWWWWWWWWWWDDW
WGGGGGGGGGGGGGGGGGGGGGGGGGGGGGGW   WGGGGGGGGGGGGGGGGW
WGGGGGGGGGGGGGGGGGGGGGGGGGGGGGGW   WGGGGGGGGGGGGGGGGW
WGGGGGGGGGGGGGGGGGGGGGGGGGGGGGGW   WGGGGGGGGGGGGGGGGW
WGGGGGGGGGGGGGGGGGGGGGGGGGGGGGGW   WGGGGGGGGGGGGGGGGW
WGGGGGGGGGGGGGGGGGGGGGGGGGGGGGGW   WGGGGGGGGGGGGGGGGW
WGGGGGGGGGGGGGGGGGGGGGGGGGGGGGGW   WWWWWWWWWWWWWWWWWW
WGGGGGGGGGGGGGGGGGGGGGGGGGGGGGGW
WGGGGGGGGGGGGGGGGGGGGGGGGGGGGGGW
WWWWWWWWWWWWWWWWWWWWWWWWWWWWWWWW