! Kilobolt Studios
! http://kilobolt.com
! Game Development Tutorial - Unit 3
! Q-Bot Level 1
! # = Tile Legend
! W = Wall
! D = Dirt
! G = Grass
WWWWWWWWWWWWWWWWWWWWWWWWWWWWWWWWWWWWWWWWWWWWWWWWWWWWWWWWWWWWWWWWWWWW
WGDGGGGGGGDGGGGGGGGDGGGGGGGGDGGGGGGGGGDGGGGGGGWDDDDDDDDDDDDDDDDDDDDW
WGDGGGGGGGDGGGGGGGGDGGGGGGGGDGGGGGGGGGDGGGGGGGDDDDDDDDDDDDDDDDDDDDDW
WGDGGGGGGGDGGGGGGGGDGGGGGGGGDGGGGGGGGGDGGGGGGGDDDDDDDDDDDDDDDDDDDDDW
WGDGGGGGGGDGGGGGGGGDGGGGGGGGDGGGGGGGGGDGGGGGGGWDDDDDDDDDDDDDDDDDDDDW
WGDGGGGGGGDGGGGGGGGDGGGGGGGGDGGGGGGGGGDGGGGGGGWWWWWWWWWWWWWWWWWWWDDW
WGDGGGGGGGDGGGGGGGGDGGGGGGGGDGGGGGGGGGDGGGGGGGW                 WDDW
WDDDDDDDDDDDDDDDDDDDDDDDDDDDDDDDDDDDDDDDDDDDDDW                 WDDW
WGDGGGGGGGDGGGGGGGGDGGGGGGGGDGGGGGGGGGDGGGGGGGW                 WDDW
WGDGGGGGGGDGGGGGGGGDGGGGGGGGDGGGGGGGGGDGGGGGGGW   WWWWWWWWWWWWWWWDDW
WGDGGGGGGGDGGGGGGGGDGGGGGGGGDGGGGGGGGGDGGGGGGGW   WWWWWWWWWWWWWWWDDW
WGDGGGGGGGDGGGGGGGGDGGGGGGGGDGGGGGGGGGDGGGGGGGW   WGGGGGGGGGGGGGGGGW
WGDGGGGGGGDGGGGGGGGDGGGGGGGGDGGGGGGGGGDGGGGGGGW   WGGGGGGGGGGGGGGGGW
WGDGGGGGGGDGGGGGGGGDGGGGGGGGDGGGGGGGGGDGGGGGGGW   WGGGGGGGGGGGGGGGGW
WDDDDDDDDDDDDDDDDDDDDDDDDDDDDDDDDDDDDDDDDDDDDDW   WGGGGGGGGGGGGGGGGW
WGDGGGGGGGDGGGGGGGGDGGGGGGGGDGGGGGGGGGDGGGGGGGW   WGGGGGGGGGGGGGGGGW
WGDGGGGGGGDGGGGGGGGDGGGGGGGGDGGGGGGGGGDGGGGGGGW   WGGGGGGGGGGGGGGGGW
WGDGGGGGGGDGGGGGGGGDGGGGGGGGDGGGGGGGGGDGGGGGGGW   WWWWWWWWWWWWWWWWWW
WGDGGGGGGGDGGGGGGGGDGGGGGGGGDGGGGGGGGGDGGGGGGGW
WGDGGGGGGGDGGGGGGGGDGGGGGGGGDGGGGGGGGGDGGGGGGGW
!WGDGGGGGGGDGGGGGGGGDGGGGGGGGDGGGGGGGGGDGGGGGGGW
!WDDDDDDDDDDDDDDDDDDDDDDDDDDDDDDDDDDDDDDDDDDDDDW
!WGDGGGGGGGDGGGGGGGGDGGGGGGGGDGGGGGGGGGDGGGGGGGW
!WGDGGGGGGGDGGGGGGGGDGGGGGGGGDGGGGGGGGGDGGGGGGGW
!WGDGGGGGGGDGGGGGGGGDGGGGGGGGDGGGGGGGGGDGGGGGGGW
!WGDGGGGGGGDGGGGGGGGDGGGGGGGGDGGGGGGGGGDGGGGGGGW
!WGDGGGGGGGDGGGGGGGGDGGGGGGGGDGGGGGGGGGDGGGGGGGW
!WGDGGGGGGGDGGGGGGGGDGGGGGGGGDGGGGGGGGGDGGGGGGGW
WWWWWWWWWWWWWWWWWWWWWWWWWWWWWWWWWWWWWWWWWWWWWWW